00000000000000000000000000000000000000000000000000000000000000000000000000000000000000000000000000000000000000000000000000000000000000000000000000000000000000000000
00000000000000000000000000000000000000000000000000000000000000000000000000000000000000000000000000000000000000000000000000000000000000000000000000000000000000000000
00000000000000000000000000000000000000000000000000000000000000000000000000000000000000000000000000000000000000000000000000000000000000000000000000000000000000000000
000000000000000000000000000000000000000000000000000000000000000000000000000000000000000000000000000000000000000000000000000Q0000000000000000000000000000000000000000
000000000000000000000000000000000000000000000000000000000000000000000000000000000000000000000000Q0000000000000000000000000123000000000000000000000000000000000000000
00000000000000000000000000000000130000000000000000000000000000000000000000000000000000000000002223000000000000000000000000000000000000000000000000000000000000000000
0000000000000000000000000000000000000000000000000000000000000000000000000000000000000000000000500000000000000000000000000000000000F000000000000000000000000000000000
000000Q0000000000000000000000130000000122230000000000000000000000000000000000000000000000022225000000000000000000000000000000001222222300000000000000000000000000000
0000012300000000F0000000000000000000000000000001230000000000050000500000000000000000013000500000000000000000000000000000000000000000000001300000000000Q0000000000000
00000050000012222230000000000000130000000000000050000000000050000005000000022300000000000050000000000000000000000000000000000000000000000000000000000123000000000000
00000050000000000000000000000000000000000000000050000F0000050000000050000005000000000F000050000000000000000000000000000000000000000000000000000000000050000000000002
22222254444444444444442222222224444444444444444452222222222544444444522222254444422222222254444444422442244224422442442222222442222222222222244422244454444422222222