00000000000000000000000000000000000000000000000000000000000000000000000000000000000000000000000000000000000000000000000000000000000000000000000000000000000000000000
00000000000000000000000000000000000000000000000000000000000000000000000000000000000000000000000000000000000000000000000000000000000000000000000000000000000000000000
00000000000000000000000000000000000000000000000000000000000000000000000000000000000000000000000000000000000000000000000000000000000000000000000000000000000000000000
0000000000000000000000000000000Q000000000000000000000000000000000000000000000000000000000000000000000000000000000000000000000000000000000000000000000000000000000000
0000000000000000000000F000000122223000000000000000000000002000000000000000000000000000000000000000000000000000000000000000000000000000000000000000000000000000000000
0000001300001300000012222300000000000000000000000000000000500F000000000000000000000000000000000000000000000000000000000000000000000000000000000000000000000000000000
00000000000000000000000000000000000000000000000000000020005002000000000000000000000000000000000000000000000000000000000000000000000000000000000000000000000000000000
0000000000000000000000000000000000000000000000000020005000500500000Q00000000000000000000000020000200002000000000000000000000Q000000000000000000000000000000000000000
12222300000000000000000001230000000000000000012300500050005005000122230000000000000000Q00000000000000000000000000000000000012300000000000000000000000000000000000000
00550000000000000000000000500000000000000000000000500050005005000005000000000000000012222300000000000000000020000000001300000000001300000000000000000000000000000000
005500000000000000000Q000050000000000000F000000000500050005005000005000000000F00000000000000000000000000000000000130000000000000000000000F00000200020000F000F0000000
44554444444444444422222444500000000002222222224444544454445445444445444444422222244444444444444444444444444444444444444444444444444444422222244544454442222222224442